NO ./maps/north.xpm
SO ./maps/south.xpm
WE ./maps/west.xpm
EA ./maps/east.xpm

F  1,9,0
C  10,0,0

  111111111111
1111000001011
111000111111
100011W00001
111111111111