
NO ./maps/north.xpm
SO ./maps/south.xpm

WE ./maps/west.xpm



EA ./maps/east.xpm

F 1,9 ,255
C 255 ,255,255


 11 111111111
1  111100001 11
111110N01111
    111111
111110000111
11 110000111
11111111111 11