

1111111111111111
1000000000000011

1001110000110011
10000S0110000011
1000010010010011


1011110000110011
1000000000110011
1001010000010011
1000000000110011
1111111111111111



