EA 
NO examplefile
SO examplefile
WE examplefile
F 0,100,255

1111111111111111111111111111111111111111111111111111111111111111
1000000001100000000000000110011000000001111001111110000110000001
1000000001100000000000000110011000000001111001111110000110000001
1001100000000000000001111110000000000000000000011000011000000111
1001100000000000000001111110000000000000000110011000011000000111
1110011000000000000110011000000110000001100110000000000000000111
1110011000000000000110011000000110000001100110000000000000000111
1000000000000000000000011111100110000000000110000000011001111111
1000000000000000000000011111100110000000000110000000011001111111
1110011001100110000000000001111000011001111111100000011000000001
1110011001100110000000000001111000011001111111100000011000000001
1000000000011000011000011110000000011111111111100111100000011111
1000000000011000011000011110000000011111111111100111100000011111
1000011000011000000110000000000001100111111110000110000110000111
1000011000011000000110000000000001100111111110000110000110000111
1000011001111000000000000000000000000000000001100111100001111111
10000110011110000000000000000000000000000W0001100111100001111111
1110000000000000000000011000000111100000000000000000000110011111
1110000000000000000000011000000111100000000000000000000110011111
1000000000000001100001111110000000000001100000000000011000011001
1000000000000001100001111100000000000001100000000000011000011001
1000011110000000000000011001111001111111100000000000000110000001
1000011110000000000000011001111001111111100000000000000110000001
1000000001111000000000000011111111100001111000000000000000011111
1000000001111000000000000111111111100001111000000000000000011111
1000011001111000000110000000000000000000000000011110000111100001
1000011001111000000110000000000000000000000000011110000111100001
1000000000000000000001100000000110000000000000000111100001111001
1000000000000000000001100000000110000000000000000111100001111001
1000000001100110011000011000011000000001111110000001100000000001
1000000001100110011000011000011000000001111110000001100000000001
1111111111111111111111111111111111111111111111111111111111111111