EA ./ressources/texture_brown.xpm
NO ./ressources/texture_brown.xpm
SO ./ressources/texture_brown.xpm
WE ./ressources/texture_brown.xpm
F 0,100,255

1111111111111111111111111111111111111111111111111111111111111111
1110011110000110000000000000000000000001100000000111111110000001
1110011110000110000000000000000000000001100000000111111110000001
1000111000000000000000000111100000000000011001100111111110000001
1001111000000000000000000111100000000000011001100111111110000001
1000000000000110000000000111111110000110000001100110011111100111
1000000000000110000000000111111110000110000001100110011111100111
1001100111100001100111100111111001111000000001100110000001100001
1001100111100001100111100111111001111000000001100110000001100001
1000011111100110000000011110000001111111111000011000000000000001
1000011111100110000000011110000001111111111000011000000000000001
1000000000000000000111111110000001100110000000000000011110011001
1000000000000000000111111110000001100110000000000000011110011001
1001100000011001100000011110000110000001100000000001111000000111
1001100000011001100000011110000110000001100000000001111000000111
1000000110000001111000011000000000011000000001100000000000011111
1000000110000001111000011000000000011000000001100000000000011111
1001100111111000000000011111111001100000011000000001100000000001
1001100111111000000000011111111001100000011000000001100000000001
1110000000011111100000011000000001100000000111100000000000011111
1110000000011111100000011000000001100000000111100000000000011111
1000011111111000000000000000000001100111100001100110000110000111
1000011111111000000000000000000001100111100001100110000110000111
1001111110011000011000011000011000011000000001100001111110011001
1001111110011000011000011000011000011000000001100001111110011001
10000000000000S0000110011000011000000001100000011110011110000001
1000000001100000000110011000011000000001100000011110011110000001
1000011111100000011001100110000111111000011111111000011000000001
1000001111100000011001100110000111111000011111111000011000000001
1001100110000000011000000000000000000110000000011000000001100111
1001100110000000011000000000000000000110000000011000000001100111
1111111111111111111111111111111111111111111111111111111111111111

