EA examplefile
NO examplefile
SO examplefile
WE examplefile
F 0,100,255

1111111111111111111111111111111111111111111111111111111111111111
1000000001100000000000000110011000000001111001111110000110000001
1000000001100000000000000110011000000001111001111110000110000001
1001100000000000000001111110000000000000000000011000011000000111
1001100000000000000001111110000000000000000110011000011000000111
11100110000000000001100110000001100000011001100000000000000001110
1110011000000000000110011000000110000001100110000000000000000111
1000000000000000000000011111100110000000000110000000011001111111
1111111111111111111111111111111111111111111111111111111111111111
