11111111111
  
  1111111111
1111111111
1N00000001
1000000001
1000000001
1001111001
1111111111