
NO ./maps/north.xpm
SO ./maps/south.xpm
WE ./maps/west.xpm
EA ./maps/east.xpm

F 1,9 ,255
C 255 ,255,255

1111111111111111111111111111111111111111111
1110111111111111111111111111111111111111111
1110N00000000000000000000000000000001110011
1110111111111111111111111111111111111111111
1111111111111111111111111111111111111111111
