
NO ./maps/north.xpm
SO ./maps/south.xpm
WE ./maps/west.xpm

EA ./maps/east.xpm

F 1,9 ,255
C 255 ,255,255


11111111111
11110000111
111111N1111
11110000111
11110000111
111111111111