
NO ./textures/north.xpm
SO ./textures/south.xpm
WE ./textures/west.xpm
EA ./textures/east.xpm

F 1,9 ,255
C 255 ,255,255

111111111111111
111011111111111
111000001110011
111000001110011
111000001110011
111000001110011
1110N1001110011
111000001110011
111001001110011
111001001110011
111000001110011
111011111111111
111111111111111
