
NO ./maps/north.xpm
SO ./maps/south.xpm
WE ./maps/west.xpm
EA ./maps/east.xpm

F 1,9 ,255
C 255 ,255,255

111111111111111
111011111111111
111000001110011
111000001110011
111000001110011
111000001110011
1110N0001110011
111000001110011
111000001110011
111000001110011
111000001110011
111011111111111
111111111111111
