
NO                              ./textures/north.xpm
SO                 ./textures/south.xpm
WE ./textures/west.xpm
EA ./textures/east.xpm

F 0,0 ,0
C 255 ,255,255

1111111111111111
1111111011111111
1000000000000001
1000000000000001
1000000000000001
1100000000000001
1100000W00000111
1100000000000001
1000000000000001
1000000000000001
1111111111111111
