WE ./textures/blue1.xpm
NO                              ./textures/black1.xpm
SO                 ./textures/red1.xpm
EA ./textures/green1.xpm

F 255,255,255
C 135     ,20 ,     235

111111
11111111111111111
1111111011111111
111111111111
110111011
110000011
1000W0111
110000011
110000011
111111111111
  111