
NO ./textures/north.xpm
SO ./textures/south.xpm
WE ./textures/west.xpm
EA ./textures/east.xpm

F 1,9 ,255
C 255 ,255,255

11111111111
11101110111
11000000011
11100000111
11100000111
11100000111
1110N100111
11100000111
11100000111
11100000111
11000000011
11101110111
11111111111
