
NO                              ./textures/north.xpm
SO                 ./textures/south.xpm
WE ./textures/west.xpm
EA ./textures/east.xpm

F 0,0 ,0
C 255 ,255,255

               111
               101
              11011
             1100011
             1000001
            110000011
            100000001
           110111111111
          11000000000011
          10000000000001
         1100000001000011
        11100E0000100000111
       1101000000010000000111
      110010000000100000000011
      1100100000001111100000111
    111000000000001   1000000111
   110000000111111111110010000011
  11000000000000000000000100000011
 1100000000000000000000000000000011
111111111111111111111111111111111111
