NO                              ./textures/north.xpm
SO                 ./textures/south.xpm
WE ./textures/west.xpm
EA ./textures/east.xpm

F 255,255,255
C 135     ,20 ,     235

11111111
1111111S11111111
1000000000000111
1111111111111111
1111111111111
            111