
NO ./maps/north.xpm
SO ./maps/south.xpm
WE ./maps/west.xpm
EA ./maps/east.xpm

F 1,9 ,255
C 255 ,255,255

11111111111111111111111111111111111111111 1
111000100001111111111111111111111111111111
1110N0000000000000000000000000000000111001
111000100001111111111111111111111111111111
1111111111111111111111111111111111111111 11
