
F 0,0,0

C 0,0,0

NO ./north

SO ./south
WE ./west

EA ./east

11111111
1W00000111
1000000001
1111111111
   111111111111
1111000001011
111000111111
1000110001
111111111111
