
F 0,0,0

C 0,0,0

NO ./north

SO ./south
WE ./west

EA ./east

11111111
1W00000111
1000000001111
1111111000001
   1111011111
111100001
111000111
100011001
111111111111
