NO ./textures/lava.jpg
SO ./textures/lava.jpg
WE ./textures/mud.jpg
EA ./textures/water.jpg
C 225,30,0


11111
10S11
10001
11111