NO ./textures/lava.jpg
SO ./textures/lava.jpg
WE ./textures/mud.jpg
EA ./textures/water.jpg
F 220,100,0
C 225,30,0

111
1011111  11
1000001 11
10000S111
11111111  1
111011 1  11
1110111111111