NO ./textures/lava.jpg
SO ./textures/lava.jpg
WE ./textures/mud.jpg
EA ./textures/water.jpg
F 220,100,0
C 225,30,0

    
11 1
10S1
1001
1111