
NO ./north
SO ./south
WE ./west
EA ./east

F 0,0,0
C 0,0,0

 1111111
100000011
100N000001
 111111111
