NO assets/textures/gre_wat.xpm
                   SO assets/textures/mir_wat.xpm
WE assets/textures/mush.xpm

EA                assets/textures/silv_wat.xpm
F 220,100,0
C 225,30,0
             

11111   
 10S11    
11001  
11111   