NO assets/textures/gre_wat.xpm
SO assets/textures/mir_wat.xpm
WE assets/textures/mush.xpm
EA assets/textures/silv_wat.xpm

F 220,100,0
C 225,30,0

        1111111111111111111111111
        1000000000110000000000001
        1011000001110000000000001
        1001000000000000000000001
111111111011000001110000000000001
100000001111000001110111111111111
111101111  111011100000010001
111101111  11101 101010010001
11000000111101011100000010001
10000000000000001100000010001
10000000000000001101010010001
11000001110101011111011110N0111
11110111 1110101 101111010001
11111111 1111111 111111111111